Census Year,SGC,Region,Immigrants,Emigrants,Returning Emigrants,Net Temporary Emigrants,Net Non-permanent Residents,Net International,Interprovincial In,Interprovincial Out,Net Interprovincial,Intraprovincial In,Intraprovincial Out,Net Intraprovincial,Net Total Migration
2001-2002,5900,British Columbia,38024,11958,3901,4925,8155,33197,47159,55715,-8556,93206,93206,0,24641
2001-2002,5901,East Kootenay,50,122,41,51,31,-51,1495,1882,-387,1401,1369,32,-406
2001-2002,5903,Central Kootenay,69,114,41,47,35,-16,948,1314,-366,1659,2116,-457,-839
2001-2002,5905,Kootenay Boundary,19,73,17,29,18,-48,360,571,-211,935,1126,-191,-450
2001-2002,5907,Okanagan-Similkameen,169,133,42,56,36,58,1291,1193,98,3663,2880,783,939
2001-2002,5909,Fraser Valley,1239,576,171,235,223,822,2615,3099,-484,9980,8891,1089,1427
2001-2002,5915,Greater Vancouver,34458,7380,2396,3039,6403,32838,18487,21849,-3362,20660,24205,-3545,25931
2001-2002,5917,Capital,834,921,435,371,553,530,5571,4817,754,8740,7876,864,2148
2001-2002,5919,Cowichan Valley,73,155,43,65,48,-56,837,712,125,3274,3068,206,275
2001-2002,5921,Nanaimo,172,318,111,133,131,-37,2144,1630,514,5960,4526,1434,1911
2001-2002,5923,Alberni-Clayoquot,9,81,11,34,12,-83,244,255,-11,979,1259,-280,-374
2001-2002,5924,Strathcona,27,83,29,35,18,-44,619,723,-104,1460,1490,-30,-178
2001-2002,5926,Comox Valley,40,118,41,49,28,-58,875,1021,-146,2060,2105,-45,-249
2001-2002,5927,Powell River,9,32,6,14,11,-20,112,192,-80,610,773,-163,-263
2001-2002,5929,Sunshine Coast,44,52,25,22,20,15,285,251,34,1533,1150,383,432
2001-2002,5931,Squamish-Lillooet,103,116,15,49,93,46,674,582,92,1657,1883,-226,-88
2001-2002,5933,Thompson-Nicola,105,316,29,128,148,-162,1341,2374,-1033,4790,4278,512,-683
2001-2002,5935,Central Okanagan,276,388,167,164,127,18,3026,3054,-28,6419,4356,2063,2053
2001-2002,5937,North Okanagan,62,149,77,62,24,-48,1134,1458,-324,3582,2686,896,524
2001-2002,5939,Columbia-Shuswap,15,102,43,43,20,-67,931,1031,-100,2283,2111,172,5
2001-2002,5941,Cariboo,51,108,45,43,26,-29,469,1075,-606,2365,2998,-633,-1268
2001-2002,5943,Mount Waddington,6,19,7,7,7,-6,124,164,-40,486,941,-455,-501
2001-2002,5945,Central Coast,2,2,4,2,3,5,30,49,-19,183,221,-38,-52
2001-2002,5947,Skeena-Queen Charlotte,25,61,1,25,15,-45,150,257,-107,669,1245,-576,-728
2001-2002,5949,Kitimat-Stikine,14,99,13,42,26,-88,301,792,-491,1155,1995,-840,-1419
2001-2002,5951,Bulkley-Nechako,32,104,10,44,17,-89,342,743,-401,1331,1914,-583,-1073
2001-2002,5953,Fraser-Fort George,67,233,47,96,43,-172,1010,2166,-1156,3253,3988,-735,-2063
2001-2002,5955,Peace River,44,99,34,40,37,-24,1448,2094,-646,1800,1465,335,-335
2001-2002,5957,Stikine,2,0,0,0,2,4,30,33,-3,43,30,13,14
2001-2002,5959,Northern Rockies,8,4,0,0,0,4,266,334,-68,276,261,15,-49
2002-2003,5900,British Columbia,31924,12837,4866,4923,6345,25375,48078,49115,-1037,93583,93583,0,24338
2002-2003,5901,East Kootenay,41,130,46,51,25,-69,1319,1535,-216,1371,1486,-115,-400
2002-2003,5903,Central Kootenay,48,134,40,53,28,-71,1023,1172,-149,1763,2077,-314,-534
2002-2003,5905,Kootenay Boundary,20,64,31,24,14,-23,339,458,-119,985,1088,-103,-245
2002-2003,5907,Okanagan-Similkameen,148,121,45,46,28,54,1287,1152,135,3513,2792,721,910
2002-2003,5909,Fraser Valley,1126,486,324,188,176,952,2487,2697,-210,10093,9079,1014,1756
2002-2003,5915,Greater Vancouver,28673,8700,2922,3327,4968,24536,18130,19594,-1464,20391,24045,-3654,19418
2002-2003,5917,Capital,683,977,384,382,436,144,5685,4312,1373,8393,8032,361,1878
2002-2003,5919,Cowichan Valley,68,85,51,33,37,38,969,653,316,3487,2886,601,955
2002-2003,5921,Nanaimo,177,207,124,81,100,113,2233,1446,787,6042,4617,1425,2325
2002-2003,5923,Alberni-Clayoquot,24,40,24,17,9,0,301,238,63,1229,1241,-12,51
2002-2003,5924,Strathcona,31,108,41,41,14,-63,690,621,69,1566,1393,173,179
2002-2003,5926,Comox Valley,44,151,58,58,23,-84,975,878,97,2212,1968,244,257
2002-2003,5927,Powell River,10,44,11,18,9,-32,184,189,-5,668,762,-94,-131
2002-2003,5929,Sunshine Coast,25,69,30,24,17,-21,325,230,95,1386,1131,255,329
2002-2003,5931,Squamish-Lillooet,100,83,56,32,72,113,757,554,203,1675,2081,-406,-90
2002-2003,5933,Thompson-Nicola,93,124,132,47,116,170,1503,2024,-521,4875,4485,390,39
2002-2003,5935,Central Okanagan,207,672,168,255,100,-452,3363,2534,829,6637,4394,2243,2620
2002-2003,5937,North Okanagan,109,134,57,52,19,-1,1273,1202,71,3652,2849,803,873
2002-2003,5939,Columbia-Shuswap,48,66,41,24,15,14,1003,935,68,2277,2135,142,224
2002-2003,5941,Cariboo,26,71,51,27,19,-2,464,855,-391,2358,2888,-530,-923
2002-2003,5943,Mount Waddington,3,49,19,19,6,-40,66,162,-96,500,865,-365,-501
2002-2003,5945,Central Coast,0,3,1,1,3,0,17,33,-16,140,301,-161,-177
2002-2003,5947,Skeena-Queen Charlotte,19,23,41,9,12,40,160,304,-144,634,1184,-550,-654
2002-2003,5949,Kitimat-Stikine,19,23,21,9,20,28,318,710,-392,1215,1887,-672,-1036
2002-2003,5951,Bulkley-Nechako,22,75,24,27,13,-43,361,606,-245,1367,1757,-390,-678
2002-2003,5953,Fraser-Fort George,127,113,88,43,35,94,1086,1951,-865,3044,4210,-1166,-1937
2002-2003,5955,Peace River,29,75,35,29,29,-11,1504,1759,-255,1757,1654,103,-163
2002-2003,5957,Stikine,0,5,0,3,2,-6,19,33,-14,31,52,-21,-41
2002-2003,5959,Northern Rockies,4,5,1,3,0,-3,237,278,-41,322,244,78,34
2003-2004,5900,British Columbia,36712,13987,4815,4923,2637,25254,50406,42541,7865,91438,91438,0,33119
2003-2004,5901,East Kootenay,62,112,40,40,11,-39,1359,1670,-311,1262,1418,-156,-506
2003-2004,5903,Central Kootenay,87,114,47,40,12,-8,1122,945,177,1734,2013,-279,-110
2003-2004,5905,Kootenay Boundary,29,68,18,25,5,-41,385,444,-59,1090,1227,-137,-237
2003-2004,5907,Okanagan-Similkameen,187,101,50,34,12,114,1494,995,499,3366,2732,634,1247
2003-2004,5909,Fraser Valley,1489,595,236,211,75,994,2557,2242,315,10405,8477,1928,3237
2003-2004,5915,Greater Vancouver,32290,10086,3078,3547,2063,23798,18853,16504,2349,18874,24383,-5509,20638
2003-2004,5917,Capital,938,1098,422,387,181,56,6023,4092,1931,7933,8021,-88,1899
2003-2004,5919,Cowichan Valley,94,112,47,40,16,5,1061,525,536,3510,2881,629,1170
2003-2004,5921,Nanaimo,282,187,159,65,42,231,2434,1123,1311,6060,4490,1570,3112
2003-2004,5923,Alberni-Clayoquot,20,22,12,8,5,7,300,228,72,1191,1222,-31,48
2003-2004,5924,Strathcona,37,68,41,24,8,-6,819,539,280,1644,1381,263,537
2003-2004,5926,Comox Valley,54,97,58,35,8,-12,1158,761,397,2323,1951,372,757
2003-2004,5927,Powell River,6,10,13,4,3,8,180,159,21,732,772,-40,-11
2003-2004,5929,Sunshine Coast,24,37,53,13,6,33,330,182,148,1435,1061,374,555
2003-2004,5931,Squamish-Lillooet,144,127,40,47,31,41,684,420,264,1487,1915,-428,-123
2003-2004,5933,Thompson-Nicola,104,136,72,50,47,37,1598,1872,-274,5056,4341,715,478
2003-2004,5935,Central Okanagan,387,325,190,112,40,180,3537,2265,1272,6001,4514,1487,2939
2003-2004,5937,North Okanagan,88,150,66,53,6,-43,1362,1075,287,3646,2844,802,1046
2003-2004,5939,Columbia-Shuswap,51,29,22,11,6,39,952,796,156,2097,2162,-65,130
2003-2004,5941,Cariboo,44,63,16,22,9,-16,487,698,-211,2313,2715,-402,-629
2003-2004,5943,Mount Waddington,11,8,8,2,2,11,93,136,-43,582,842,-260,-292
2003-2004,5945,Central Coast,5,8,0,2,1,-4,27,31,-4,192,178,14,6
2003-2004,5947,Skeena-Queen Charlotte,27,32,14,11,5,3,151,253,-102,548,1007,-459,-558
2003-2004,5949,Kitimat-Stikine,28,116,20,39,10,-97,342,587,-245,1125,1639,-514,-856
2003-2004,5951,Bulkley-Nechako,44,61,40,22,6,7,370,512,-142,1398,1620,-222,-357
2003-2004,5953,Fraser-Fort George,73,106,44,37,14,-12,1076,1611,-535,3308,3687,-379,-926
2003-2004,5955,Peace River,100,111,9,39,13,-28,1335,1604,-269,1774,1599,175,-122
2003-2004,5957,Stikine,0,4,0,2,0,-6,24,37,-13,54,52,2,-17
2003-2004,5959,Northern Rockies,7,4,0,1,0,2,293,235,58,298,294,4,64
2004-2005,5900,British Columbia,40577,12883,5678,4925,5711,34158,54280,46066,8214,95150,95150,0,42372
2004-2005,5901,East Kootenay,70,116,53,46,21,-18,1565,1682,-117,1373,1502,-129,-264
2004-2005,5903,Central Kootenay,52,92,51,35,23,-1,1138,1185,-47,1969,2013,-44,-92
2004-2005,5905,Kootenay Boundary,38,64,19,24,14,-17,515,477,38,1382,1154,228,249
2004-2005,5907,Okanagan-Similkameen,156,115,59,44,25,81,1528,1053,475,3270,3019,251,807
2004-2005,5909,Fraser Valley,1350,407,207,152,156,1154,2723,2676,47,10318,9000,1318,2519
2004-2005,5915,Greater Vancouver,35990,9314,3656,3550,4488,31270,20790,17814,2976,19429,24913,-5484,28762
2004-2005,5917,Capital,1151,980,587,380,385,763,6216,4134,2082,8123,8102,21,2866
2004-2005,5919,Cowichan Valley,105,118,77,48,33,49,964,662,302,3519,2976,543,894
2004-2005,5921,Nanaimo,263,232,169,86,90,204,2687,1401,1286,6032,4784,1248,2738
2004-2005,5923,Alberni-Clayoquot,22,19,21,8,7,23,338,261,77,1345,1225,120,220
2004-2005,5924,Strathcona,49,71,30,28,16,-4,842,564,278,1661,1442,219,493
2004-2005,5926,Comox Valley,70,103,42,39,18,-12,1188,796,392,2346,2036,310,690
2004-2005,5927,Powell River,22,26,4,11,7,-4,237,169,68,854,802,52,116
2004-2005,5929,Sunshine Coast,42,19,45,8,15,75,316,205,111,1360,1095,265,451
2004-2005,5931,Squamish-Lillooet,133,99,51,37,64,112,767,536,231,1379,2173,-794,-451
2004-2005,5933,Thompson-Nicola,116,201,93,78,104,34,1617,1858,-241,5323,4397,926,719
2004-2005,5935,Central Okanagan,401,337,229,131,89,251,3751,2542,1209,6025,4776,1249,2709
2004-2005,5937,North Okanagan,96,161,86,64,18,-25,1473,1039,434,3878,2902,976,1385
2004-2005,5939,Columbia-Shuswap,67,61,34,23,14,31,1073,889,184,2391,2150,241,456
2004-2005,5941,Cariboo,67,54,22,21,18,32,571,766,-195,2817,2811,6,-157
2004-2005,5943,Mount Waddington,7,24,0,10,5,-22,111,127,-16,627,801,-174,-212
2004-2005,5945,Central Coast,0,0,0,0,2,2,24,16,8,192,230,-38,-28
2004-2005,5947,Skeena-Queen Charlotte,35,6,1,2,11,39,158,276,-118,723,1057,-334,-413
2004-2005,5949,Kitimat-Stikine,18,47,19,17,18,-9,376,544,-168,1208,1903,-695,-872
2004-2005,5951,Bulkley-Nechako,25,72,7,28,12,-56,403,577,-174,1351,1871,-520,-750
2004-2005,5953,Fraser-Fort George,150,117,74,44,31,94,1179,1573,-394,3842,3810,32,-268
2004-2005,5955,Peace River,79,24,39,9,25,110,1412,1829,-417,2019,1811,208,-99
2004-2005,5957,Stikine,1,4,3,2,2,0,27,26,1,42,54,-12,-11
2004-2005,5959,Northern Rockies,2,0,0,0,0,2,291,389,-98,352,341,11,-85
2005-2006,5900,British Columbia,43846,12296,6607,4926,4858,38089,53096,44296,8800,91185,91185,0,46889
2005-2006,5901,East Kootenay,88,95,53,44,111,113,1616,1607,9,1274,1291,-17,105
2005-2006,5903,Central Kootenay,110,150,59,36,52,35,1160,960,200,1798,2035,-237,-2
2005-2006,5905,Kootenay Boundary,31,58,21,25,-131,-162,505,427,78,1318,1218,100,16
2005-2006,5907,Okanagan-Similkameen,187,127,63,44,-155,-76,1292,1110,182,3126,2815,311,417
2005-2006,5909,Fraser Valley,1822,403,221,152,-105,1383,2569,2523,46,9889,8782,1107,2536
2005-2006,5915,Greater Vancouver,38296,9215,4517,3562,4152,34188,20247,17107,3140,18470,24090,-5620,31708
2005-2006,5917,Capital,1235,860,522,384,1776,2289,5724,4287,1437,7785,7577,208,3934
2005-2006,5919,Cowichan Valley,96,113,102,45,-26,14,994,666,328,3286,2774,512,854
2005-2006,5921,Nanaimo,321,148,183,86,283,553,2326,1374,952,5580,4600,980,2485
2005-2006,5923,Alberni-Clayoquot,22,31,19,7,-50,-47,251,219,32,1217,1300,-83,-98
2005-2006,5924,Strathcona,57,58,44,28,-5,10,791,588,203,1516,1352,164,377
2005-2006,5926,Comox Valley,88,82,61,39,-202,-174,1116,831,285,2142,1910,232,343
2005-2006,5927,Powell River,22,10,14,11,-13,2,194,152,42,861,741,120,164
2005-2006,5929,Sunshine Coast,48,28,36,7,-115,-66,341,173,168,1196,1096,100,202
2005-2006,5931,Squamish-Lillooet,177,121,32,35,507,560,770,467,303,1444,2040,-596,267
2005-2006,5933,Thompson-Nicola,195,99,111,78,-368,-239,1738,1788,-50,5490,4240,1250,961
2005-2006,5935,Central Okanagan,379,272,251,127,-131,100,3917,2379,1538,6308,4498,1810,3448
2005-2006,5937,North Okanagan,111,72,80,60,-47,12,1464,1153,311,3379,3163,216,539
2005-2006,5939,Columbia-Shuswap,83,43,38,23,-43,12,1047,856,191,2330,1982,348,551
2005-2006,5941,Cariboo,72,34,43,20,-160,-99,684,704,-20,2807,2701,106,-13
2005-2006,5943,Mount Waddington,5,17,16,10,-44,-50,101,124,-23,555,846,-291,-364
2005-2006,5945,Central Coast,5,20,0,0,-29,-44,24,28,-4,128,176,-48,-96
2005-2006,5947,Skeena-Queen Charlotte,38,5,10,3,-86,-46,148,185,-37,637,1004,-367,-450
2005-2006,5949,Kitimat-Stikine,56,43,18,16,-199,-184,304,549,-245,1201,1648,-447,-876
2005-2006,5951,Bulkley-Nechako,55,28,19,28,-92,-74,388,486,-98,1334,1634,-300,-472
2005-2006,5953,Fraser-Fort George,153,104,59,44,116,180,1299,1452,-153,3577,3578,-1,26
2005-2006,5955,Peace River,82,60,13,9,-147,-121,1767,1725,42,2202,1655,547,468
2005-2006,5957,Stikine,0,0,0,3,-11,-14,6,28,-22,52,32,20,-16
2005-2006,5959,Northern Rockies,12,0,2,0,20,34,313,348,-35,283,407,-124,-125
2006-2007,5900,British Columbia,37811,13259,6181,5798,8328,33263,58182,43177,15005,92794,92794,0,48268
2006-2007,5901,East Kootenay,98,38,61,17,102,206,1819,1272,547,1281,1305,-24,729
2006-2007,5903,Central Kootenay,136,83,43,37,-20,39,1470,887,583,1803,1871,-68,554
2006-2007,5905,Kootenay Boundary,37,40,16,18,38,33,594,388,206,1299,1197,102,341
2006-2007,5907,Okanagan-Similkameen,202,94,68,41,15,150,1501,952,549,3044,2865,179,878
2006-2007,5909,Fraser Valley,1430,577,216,243,287,1113,2742,2434,308,10358,8806,1552,2973
2006-2007,5915,Greater Vancouver,32245,9838,4252,4302,6098,28455,21604,17649,3955,18837,24771,-5934,26476
2006-2007,5917,Capital,1295,860,527,390,647,1219,6232,4102,2130,8291,7737,554,3903
2006-2007,5919,Cowichan Valley,125,132,63,57,46,45,1028,772,256,3331,3101,230,531
2006-2007,5921,Nanaimo,347,191,159,83,-64,168,2575,1381,1194,5602,4667,935,2297
2006-2007,5923,Alberni-Clayoquot,53,26,15,12,-5,25,304,219,85,1137,1336,-199,-89
2006-2007,5924,Strathcona,74,58,36,25,35,62,850,662,188,1589,1416,173,423
2006-2007,5926,Comox Valley,91,82,50,35,90,114,1200,934,266,2246,2000,246,626
2006-2007,5927,Powell River,49,20,20,8,-27,14,210,112,98,844,716,128,240
2006-2007,5929,Sunshine Coast,75,23,51,10,-1,92,330,163,167,1374,1097,277,536
2006-2007,5931,Squamish-Lillooet,182,116,55,51,481,551,945,434,511,1689,1840,-151,911
2006-2007,5933,Thompson-Nicola,180,159,63,67,136,153,2009,1559,450,5400,3983,1417,2020
2006-2007,5935,Central Okanagan,457,295,197,127,204,436,4436,2232,2204,5924,4740,1184,3824
2006-2007,5937,North Okanagan,141,82,77,36,82,182,1594,1079,515,3368,3233,135,832
2006-2007,5939,Columbia-Shuswap,80,85,35,38,24,16,1344,751,593,2245,2023,222,831
2006-2007,5941,Cariboo,60,86,33,39,29,-3,736,720,16,3033,2940,93,106
2006-2007,5943,Mount Waddington,15,31,10,12,10,-8,166,107,59,644,691,-47,4
2006-2007,5945,Central Coast,2,0,0,0,7,9,21,21,0,164,200,-36,-27
2006-2007,5947,Skeena-Queen Charlotte,30,34,10,15,34,25,201,191,10,701,922,-221,-186
2006-2007,5949,Kitimat-Stikine,51,96,6,41,9,-71,499,470,29,1340,1635,-295,-337
2006-2007,5951,Bulkley-Nechako,41,61,26,26,4,-16,479,447,32,1328,1784,-456,-440
2006-2007,5953,Fraser-Fort George,190,89,46,40,20,127,1276,1274,2,3517,3484,33,162
2006-2007,5955,Peace River,107,59,29,26,46,97,1759,1609,150,2117,1921,196,443
2006-2007,5957,Stikine,1,0,2,0,-4,-1,18,27,-9,34,45,-11,-21
2006-2007,5959,Northern Rockies,17,4,15,2,5,31,240,329,-89,254,468,-214,-272
2007-2008,5900,British Columbia,43220,12163,5695,5798,11119,42073,57396,42753,14643,90049,90049,0,56716
2007-2008,5901,East Kootenay,161,98,28,46,80,125,1888,1244,644,1287,1234,53,822
2007-2008,5903,Central Kootenay,105,87,62,41,-7,32,1345,834,511,1801,1686,115,658
2007-2008,5905,Kootenay Boundary,63,24,18,11,15,61,505,397,108,1197,1142,55,224
2007-2008,5907,Okanagan-Similkameen,218,72,56,34,5,173,1441,1086,355,3054,2724,330,858
2007-2008,5909,Fraser Valley,1583,263,225,126,23,1442,2714,2483,231,9929,8397,1532,3205
2007-2008,5915,Greater Vancouver,36617,9449,3945,4504,9593,36202,21323,17497,3826,18402,24012,-5610,34418
2007-2008,5917,Capital,1526,900,447,432,128,769,6788,4057,2731,8628,7715,913,4413
2007-2008,5919,Cowichan Valley,182,96,66,46,-4,102,1042,644,398,3482,3107,375,875
2007-2008,5921,Nanaimo,391,202,140,95,-4,230,2624,1333,1291,5760,4810,950,2471
2007-2008,5923,Alberni-Clayoquot,42,25,22,12,14,41,313,201,112,1232,1236,-4,149
2007-2008,5924,Strathcona,93,57,25,28,-56,-23,830,624,206,1563,1397,166,349
2007-2008,5926,Comox Valley,115,82,35,39,17,46,1172,882,290,2207,1971,236,572
2007-2008,5927,Powell River,37,14,2,6,0,19,218,152,66,818,747,71,156
2007-2008,5929,Sunshine Coast,78,11,26,5,9,97,290,172,118,1463,1043,420,635
2007-2008,5931,Squamish-Lillooet,237,78,77,37,367,566,903,433,470,1789,1783,6,1042
2007-2008,5933,Thompson-Nicola,296,96,99,45,236,490,1888,1536,352,5143,4140,1003,1845
2007-2008,5935,Central Okanagan,612,241,183,115,386,825,4484,2284,2200,5592,4499,1093,4118
2007-2008,5937,North Okanagan,160,118,66,55,134,187,1614,941,673,2996,2877,119,979
2007-2008,5939,Columbia-Shuswap,110,44,26,20,88,160,1314,812,502,2102,2095,7,669
2007-2008,5941,Cariboo,117,42,41,21,1,96,604,689,-85,2665,2591,74,85
2007-2008,5943,Mount Waddington,28,4,6,2,-1,27,163,97,66,556,645,-89,4
2007-2008,5945,Central Coast,11,0,0,0,-6,5,19,14,5,160,207,-47,-37
2007-2008,5947,Skeena-Queen Charlotte,43,17,10,9,-21,6,185,175,10,771,856,-85,-69
2007-2008,5949,Kitimat-Stikine,31,4,20,3,2,46,488,392,96,1257,1430,-173,-31
2007-2008,5951,Bulkley-Nechako,48,45,24,22,-16,-11,454,448,6,1341,1752,-411,-416
2007-2008,5953,Fraser-Fort George,175,46,24,21,67,199,1164,1453,-289,3043,3700,-657,-747
2007-2008,5955,Peace River,127,47,22,22,51,131,1419,1556,-137,1594,1829,-235,-241
2007-2008,5957,Stikine,1,1,0,1,9,8,34,26,8,43,39,4,20
2007-2008,5959,Northern Rockies,13,0,0,0,9,22,170,291,-121,174,385,-211,-310
2008-2009,5900,British Columbia,42375,11240,5403,5800,17683,48421,51061,41066,9995,79514,79514,0,58416
2008-2009,5901,East Kootenay,168,44,52,23,223,376,1451,1297,154,1067,1170,-103,427
2008-2009,5903,Central Kootenay,129,68,45,36,25,95,1031,746,285,1597,1596,1,381
2008-2009,5905,Kootenay Boundary,44,22,16,11,25,52,370,383,-13,1032,955,77,116
2008-2009,5907,Okanagan-Similkameen,207,119,59,61,123,209,1140,1005,135,2384,2482,-98,246
2008-2009,5909,Fraser Valley,1705,356,184,180,63,1416,2495,2302,193,8521,7455,1066,2675
2008-2009,5915,Greater Vancouver,35977,8334,3773,4312,14705,41809,20467,15856,4611,17738,19693,-1955,44465
2008-2009,5917,Capital,1463,880,468,448,534,1137,6349,3658,2691,8310,6503,1807,5635
2008-2009,5919,Cowichan Valley,125,89,59,45,25,75,908,684,224,2991,2724,267,566
2008-2009,5921,Nanaimo,367,174,124,90,81,308,2189,1381,808,4879,4351,528,1644
2008-2009,5923,Alberni-Clayoquot,59,25,11,12,26,59,247,196,51,1114,1051,63,173
2008-2009,5924,Strathcona,110,74,34,38,-13,19,730,641,89,1299,1344,-45,63
2008-2009,5926,Comox Valley,105,104,47,53,10,5,1031,905,126,1836,1899,-63,68
2008-2009,5927,Powell River,30,9,5,5,-2,19,170,167,3,668,693,-25,-3
2008-2009,5929,Sunshine Coast,75,25,10,14,8,54,273,179,94,1067,929,138,286
2008-2009,5931,Squamish-Lillooet,268,89,68,47,706,906,867,345,522,1356,1669,-313,1115
2008-2009,5933,Thompson-Nicola,246,136,75,68,268,385,1594,1606,-12,4113,3837,276,649
2008-2009,5935,Central Okanagan,545,304,174,157,513,771,3736,2521,1215,5088,4048,1040,3026
2008-2009,5937,North Okanagan,143,84,50,44,61,126,1144,1008,136,2527,2411,116,378
2008-2009,5939,Columbia-Shuswap,88,63,27,33,58,77,985,809,176,1737,1760,-23,230
2008-2009,5941,Cariboo,64,52,15,26,15,16,479,721,-242,2061,2554,-493,-719
2008-2009,5943,Mount Waddington,25,6,2,4,-6,11,102,115,-13,414,641,-227,-229
2008-2009,5945,Central Coast,1,2,0,2,1,-2,32,16,16,166,188,-22,-8
2008-2009,5947,Skeena-Queen Charlotte,42,6,7,2,-17,24,143,157,-14,655,850,-195,-185
2008-2009,5949,Kitimat-Stikine,57,29,25,14,30,69,444,463,-19,1130,1345,-215,-165
2008-2009,5951,Bulkley-Nechako,57,11,29,5,13,83,333,493,-160,1170,1740,-570,-647
2008-2009,5953,Fraser-Fort George,164,80,30,41,106,179,914,1621,-707,2662,3703,-1041,-1569
2008-2009,5955,Peace River,93,54,14,28,99,124,1256,1493,-237,1634,1609,25,-88
2008-2009,5957,Stikine,4,0,0,0,-8,-4,12,26,-14,44,35,9,-9
2008-2009,5959,Northern Rockies,14,1,0,1,11,23,169,272,-103,254,279,-25,-105
2009-2010,5900,British Columbia,43871,11589,5913,5799,11174,43570,49469,40741,8728,81289,81289,0,52298
2009-2010,5901,East Kootenay,162,53,32,26,66,181,1296,1260,36,995,1118,-123,94
2009-2010,5903,Central Kootenay,243,47,46,24,9,227,975,785,190,1509,1553,-44,373
2009-2010,5905,Kootenay Boundary,64,17,18,7,-10,48,405,361,44,963,915,48,140
2009-2010,5907,Okanagan-Similkameen,212,126,60,63,-52,31,1193,912,281,2480,2611,-131,181
2009-2010,5909,Fraser Valley,1576,346,169,175,192,1416,2398,2360,38,9168,7780,1388,2842
2009-2010,5915,Greater Vancouver,36850,8906,4270,4460,10467,38221,20004,16465,3539,18714,20535,-1821,39939
2009-2010,5917,Capital,1684,769,464,386,64,1057,6224,3852,2372,8208,6847,1361,4790
2009-2010,5919,Cowichan Valley,164,116,77,58,-20,47,895,630,265,3200,3026,174,486
2009-2010,5921,Nanaimo,371,141,140,70,39,339,2187,1470,717,5209,4273,936,1992
2009-2010,5923,Alberni-Clayoquot,40,17,29,9,30,73,270,199,71,1037,1102,-65,79
2009-2010,5924,Strathcona,63,80,47,40,8,-2,735,606,129,1334,1354,-20,107
2009-2010,5926,Comox Valley,118,113,68,56,29,46,1036,857,179,1885,1913,-28,197
2009-2010,5927,Powell River,39,7,7,3,3,39,180,140,40,606,620,-14,65
2009-2010,5929,Sunshine Coast,83,17,13,7,19,91,225,199,26,1188,1016,172,289
2009-2010,5931,Squamish-Lillooet,345,78,48,39,-156,120,637,440,197,1627,1606,21,338
2009-2010,5933,Thompson-Nicola,323,104,56,51,142,366,1460,1456,4,3991,4184,-193,177
2009-2010,5935,Central Okanagan,641,249,183,124,166,617,3674,2439,1235,5276,4227,1049,2901
2009-2010,5937,North Okanagan,155,117,58,58,16,54,1158,952,206,2389,2637,-248,12
2009-2010,5939,Columbia-Shuswap,114,44,31,22,38,117,958,709,249,1691,1795,-104,262
2009-2010,5941,Cariboo,95,22,25,11,-10,77,486,586,-100,1953,2517,-564,-587
2009-2010,5943,Mount Waddington,8,3,2,1,5,11,69,103,-34,492,552,-60,-83
2009-2010,5945,Central Coast,1,0,2,0,0,3,28,15,13,152,165,-13,3
2009-2010,5947,Skeena-Queen Charlotte,56,17,7,7,3,42,137,185,-48,563,785,-222,-228
2009-2010,5949,Kitimat-Stikine,57,28,10,15,4,28,328,417,-89,1029,1394,-365,-426
2009-2010,5951,Bulkley-Nechako,59,32,9,17,-12,7,301,378,-77,1114,1482,-368,-438
2009-2010,5953,Fraser-Fort George,206,68,24,35,82,209,895,1329,-434,2802,3338,-536,-761
2009-2010,5955,Peace River,130,68,14,33,33,76,1116,1408,-292,1421,1656,-235,-451
2009-2010,5957,Stikine,1,0,0,0,-4,-3,29,19,10,28,27,1,8
2009-2010,5959,Northern Rockies,11,4,4,2,23,32,170,209,-39,265,261,4,-3
2010-2011,5900,British Columbia,38947,11809,5334,5797,399,27074,47854,44433,3421,81283,81283,0,30495
2010-2011,5901,East Kootenay,143,84,32,41,-92,-42,1134,1233,-99,1032,1152,-120,-261
2010-2011,5903,Central Kootenay,114,91,28,44,-36,-29,1027,845,182,1474,1569,-95,58
2010-2011,5905,Kootenay Boundary,32,46,10,22,-9,-35,351,353,-2,886,963,-77,-114
2010-2011,5907,Okanagan-Similkameen,189,124,54,60,-57,2,1281,1035,246,2693,2498,195,443
2010-2011,5909,Fraser Valley,1341,477,162,228,-152,646,2155,2409,-254,8987,7696,1291,1683
2010-2011,5915,Greater Vancouver,32857,8783,3872,4311,1619,25254,19631,18532,1099,18495,20559,-2064,24289
2010-2011,5917,Capital,1363,798,449,406,-651,-43,5889,4251,1638,8054,7449,605,2200
2010-2011,5919,Cowichan Valley,112,103,39,50,16,14,773,711,62,3036,2812,224,300
2010-2011,5921,Nanaimo,550,175,152,86,-56,385,2046,1551,495,5206,4521,685,1565
2010-2011,5923,Alberni-Clayoquot,60,43,3,20,5,5,246,240,6,1008,1089,-81,-70
2010-2011,5924,Strathcona,61,66,21,33,1,-16,698,619,79,1353,1227,126,189
2010-2011,5926,Comox Valley,110,95,30,47,39,37,984,876,108,1911,1732,179,324
2010-2011,5927,Powell River,38,18,6,9,-10,7,143,126,17,629,718,-89,-65
2010-2011,5929,Sunshine Coast,108,19,32,8,-5,108,258,222,36,1105,1024,81,225
2010-2011,5931,Squamish-Lillooet,350,79,60,39,-217,75,748,499,249,1592,1592,0,324
2010-2011,5933,Thompson-Nicola,255,163,62,79,94,169,1478,1581,-103,4054,4151,-97,-31
2010-2011,5935,Central Okanagan,500,231,164,113,-135,185,3530,2658,872,5475,4389,1086,2143
2010-2011,5937,North Okanagan,106,88,49,43,-14,10,1078,1104,-26,2495,2697,-202,-218
2010-2011,5939,Columbia-Shuswap,103,60,14,30,-32,-5,856,788,68,1659,1787,-128,-65
2010-2011,5941,Cariboo,92,36,13,17,4,56,397,675,-278,1910,2293,-383,-605
2010-2011,5943,Mount Waddington,16,12,2,6,-10,-10,91,73,18,444,556,-112,-104
2010-2011,5945,Central Coast,1,0,0,0,-2,-1,28,12,16,163,159,4,19
2010-2011,5947,Skeena-Queen Charlotte,33,13,8,7,-9,12,125,146,-21,572,826,-254,-263
2010-2011,5949,Kitimat-Stikine,32,44,12,20,25,5,281,513,-232,1089,1428,-339,-566
2010-2011,5951,Bulkley-Nechako,42,40,23,19,8,14,274,380,-106,1005,1552,-547,-639
2010-2011,5953,Fraser-Fort George,177,49,13,23,59,177,930,1300,-370,2781,2988,-207,-400
2010-2011,5955,Peace River,150,68,22,34,11,81,1211,1407,-196,1884,1554,330,215
2010-2011,5957,Stikine,2,1,0,1,6,6,20,25,-5,33,35,-2,-1
2010-2011,5959,Northern Rockies,10,3,2,1,-1,7,191,269,-78,258,267,-9,-80
2011-2012,5900,British Columbia,36250,13258,5576,5237,12420,35751,48593,51304,-2711,88634,88634,0,33040
2011-2012,5901,East Kootenay,154,73,34,29,37,123,1267,1415,-148,1341,1106,235,210
2011-2012,5903,Central Kootenay,118,97,38,39,8,28,902,1011,-109,1601,1946,-345,-426
2011-2012,5905,Kootenay Boundary,65,46,15,19,-23,-8,384,317,67,1062,1008,54,113
2011-2012,5907,Okanagan-Similkameen,164,146,45,58,-2,3,1190,1109,81,2768,3537,-769,-685
2011-2012,5909,Fraser Valley,1547,481,157,176,294,1341,2290,3017,-727,9685,8142,1543,2157
2011-2012,5915,Greater Vancouver,29630,9542,4251,3762,9255,29832,19402,21877,-2475,19563,22711,-3148,24209
2011-2012,5917,Capital,1528,1096,334,450,2277,2593,6032,4728,1304,8952,7500,1452,5349
2011-2012,5919,Cowichan Valley,150,104,57,41,-69,-7,711,887,-176,3075,3019,56,-127
2011-2012,5921,Nanaimo,309,238,95,94,61,133,2032,1778,254,5535,4702,833,1220
2011-2012,5923,Alberni-Clayoquot,44,40,7,16,3,-2,215,296,-81,925,1192,-267,-350
2011-2012,5924,Strathcona,82,73,23,29,-4,-1,510,517,-7,1743,1825,-82,-90
2011-2012,5926,Comox Valley,127,83,44,33,5,60,1244,1065,179,2217,2167,50,289
2011-2012,5927,Powell River,29,4,5,2,-3,25,119,178,-59,712,742,-30,-64
2011-2012,5929,Sunshine Coast,82,54,25,22,-12,19,246,291,-45,1214,1237,-23,-49
2011-2012,5931,Squamish-Lillooet,428,133,40,52,-310,-27,819,449,370,2015,1393,622,965
2011-2012,5933,Thompson-Nicola,259,178,66,71,160,236,1369,1715,-346,4451,4404,47,-63
2011-2012,5935,Central Okanagan,598,415,171,164,-140,50,3826,3374,452,6057,4561,1496,1998
2011-2012,5937,North Okanagan,127,111,49,45,1,21,1215,1205,10,2800,2573,227,258
2011-2012,5939,Columbia-Shuswap,89,42,20,17,51,101,882,1015,-133,1781,2114,-333,-365
2011-2012,5941,Cariboo,99,51,10,20,23,61,486,698,-212,2064,2573,-509,-660
2011-2012,5943,Mount Waddington,22,24,2,9,240,231,59,96,-37,466,709,-243,-49
2011-2012,5945,Central Coast,5,0,0,0,4,9,27,28,-1,114,174,-60,-52
2011-2012,5947,Skeena-Queen Charlotte,34,4,3,2,-3,28,144,165,-21,647,844,-197,-190
2011-2012,5949,Kitimat-Stikine,56,27,5,10,63,87,373,428,-55,1168,1418,-250,-218
2011-2012,5951,Bulkley-Nechako,41,54,16,21,5,-13,356,367,-11,1202,1574,-372,-396
2011-2012,5953,Fraser-Fort George,183,79,22,31,111,206,898,1232,-334,2944,3240,-296,-424
2011-2012,5955,Peace River,258,63,40,25,106,316,1390,1715,-325,2258,1882,376,367
2011-2012,5957,Stikine,4,0,0,0,-3,1,32,50,-18,41,60,-19,-36
2011-2012,5959,Northern Rockies,18,0,2,0,285,305,173,281,-108,233,281,-48,149
2012-2013,5900,British Columbia,35738,12873,5486,5236,10734,33849,43830,45698,-1868,77383,77383,0,31981
2012-2013,5901,East Kootenay,147,62,32,25,151,243,1212,1276,-64,1127,1064,63,242
2012-2013,5903,Central Kootenay,121,150,38,60,43,-8,909,894,15,1381,1443,-62,-55
2012-2013,5905,Kootenay Boundary,50,74,8,30,30,-16,343,340,3,815,961,-146,-159
2012-2013,5907,Okanagan-Similkameen,148,114,37,46,88,113,1137,995,142,2326,2384,-58,197
2012-2013,5909,Fraser Valley,1440,443,147,172,466,1438,2174,2786,-612,8256,7321,935,1761
2012-2013,5915,Greater Vancouver,29822,9560,4087,3884,5490,25955,16801,19314,-2513,16497,19952,-3455,19987
2012-2013,5917,Capital,1271,882,429,373,2388,2833,5176,4221,955,7896,6507,1389,5177
2012-2013,5919,Cowichan Valley,125,114,52,47,113,129,822,777,45,2850,2819,31,205
2012-2013,5921,Nanaimo,269,244,118,99,324,368,1944,1566,378,4871,4104,767,1513
2012-2013,5923,Alberni-Clayoquot,54,34,12,14,9,27,206,272,-66,843,1055,-212,-251
2012-2013,5924,Strathcona,79,37,7,15,21,55,483,518,-35,1520,1512,8,28
2012-2013,5926,Comox Valley,99,107,48,44,53,49,1103,1099,4,1944,1948,-4,49
2012-2013,5927,Powell River,19,34,10,14,23,4,167,155,12,586,582,4,20
2012-2013,5929,Sunshine Coast,94,82,16,33,31,26,214,174,40,1030,1137,-107,-41
2012-2013,5931,Squamish-Lillooet,352,144,38,59,157,344,676,424,252,1642,1537,105,701
2012-2013,5933,Thompson-Nicola,250,140,53,57,466,572,1268,1566,-298,4020,3518,502,776
2012-2013,5935,Central Okanagan,533,268,165,108,246,568,3432,2961,471,5524,4060,1464,2503
2012-2013,5937,North Okanagan,98,111,44,45,33,19,1142,1138,4,2530,2527,3,26
2012-2013,5939,Columbia-Shuswap,78,36,20,15,55,102,916,842,74,1693,1746,-53,123
2012-2013,5941,Cariboo,95,46,24,19,36,90,431,543,-112,1826,2202,-376,-398
2012-2013,5943,Mount Waddington,20,0,7,0,-62,-35,68,62,6,463,577,-114,-143
2012-2013,5945,Central Coast,2,0,1,0,1,4,27,19,8,130,137,-7,5
2012-2013,5947,Skeena-Queen Charlotte,20,10,5,4,32,43,160,168,-8,555,721,-166,-131
2012-2013,5949,Kitimat-Stikine,56,28,14,11,107,138,377,318,59,1033,1167,-134,63
2012-2013,5951,Bulkley-Nechako,57,37,32,15,64,101,342,342,0,1110,1509,-399,-298
2012-2013,5953,Fraser-Fort George,190,40,24,16,294,452,912,1066,-154,2723,2864,-141,157
2012-2013,5955,Peace River,214,76,14,31,184,305,1234,1588,-354,1961,1689,272,223
2012-2013,5957,Stikine,6,0,0,0,-1,5,26,24,2,34,69,-35,-28
2012-2013,5959,Northern Rockies,29,0,4,0,-108,-75,128,250,-122,197,271,-74,-271
2013-2014,5900,British Columbia,37520,12978,5884,5237,11603,36792,52281,42806,9475,79844,79844,0,46267
2013-2014,5901,East Kootenay,270,99,39,39,-16,155,1411,1078,333,1096,1080,16,504
2013-2014,5903,Central Kootenay,101,83,38,33,23,46,1024,863,161,1444,1524,-80,127
2013-2014,5905,Kootenay Boundary,38,26,25,11,31,57,329,343,-14,893,936,-43,0
2013-2014,5907,Okanagan-Similkameen,186,93,44,37,65,165,1517,938,579,2605,2324,281,1025
2013-2014,5909,Fraser Valley,1524,365,174,143,-40,1150,2603,2593,10,8830,7699,1131,2291
2013-2014,5915,Greater Vancouver,30466,9775,4347,3954,9993,31077,19760,18268,1492,16826,21214,-4388,28181
2013-2014,5917,Capital,1348,933,445,372,55,543,6184,3915,2269,7958,6715,1243,4055
2013-2014,5919,Cowichan Valley,133,80,47,32,85,153,1052,724,328,3064,2706,358,839
2013-2014,5921,Nanaimo,341,214,148,87,263,451,2582,1438,1144,4940,4219,721,2316
2013-2014,5923,Alberni-Clayoquot,45,28,7,11,-12,1,321,248,73,975,1041,-66,8
2013-2014,5924,Strathcona,94,45,37,18,-3,65,640,442,198,1503,1566,-63,200
2013-2014,5926,Comox Valley,126,100,42,41,63,90,1220,939,281,2114,1858,256,627
2013-2014,5927,Powell River,27,29,19,12,6,11,205,135,70,546,596,-50,31
2013-2014,5929,Sunshine Coast,97,57,30,23,-15,32,304,181,123,1075,918,157,312
2013-2014,5931,Squamish-Lillooet,494,121,49,49,206,579,680,429,251,1749,1490,259,1089
2013-2014,5933,Thompson-Nicola,285,133,66,54,58,222,1518,1472,46,4124,3769,355,623
2013-2014,5935,Central Okanagan,651,340,146,137,246,566,4435,2823,1612,5706,4249,1457,3635
2013-2014,5937,North Okanagan,121,129,48,52,20,8,1492,1016,476,2727,2424,303,787
2013-2014,5939,Columbia-Shuswap,151,65,22,26,-6,76,1034,844,190,1746,1926,-180,86
2013-2014,5941,Cariboo,108,52,19,21,35,89,551,527,24,1882,2178,-296,-183
2013-2014,5943,Mount Waddington,23,6,3,3,59,76,114,73,41,441,588,-147,-30
2013-2014,5945,Central Coast,1,0,1,0,1,3,18,19,-1,117,204,-87,-85
2013-2014,5947,Skeena-Queen Charlotte,50,11,6,4,27,68,132,161,-29,536,700,-164,-125
2013-2014,5949,Kitimat-Stikine,84,28,16,11,222,283,448,279,169,1248,1316,-68,384
2013-2014,5951,Bulkley-Nechako,87,49,10,20,14,42,389,282,107,1089,1518,-429,-280
2013-2014,5953,Fraser-Fort George,266,79,20,32,135,310,930,1008,-78,2593,2927,-334,-102
2013-2014,5955,Peace River,321,38,34,15,174,476,1239,1474,-235,1832,1857,-25,216
2013-2014,5957,Stikine,2,0,0,0,0,2,16,32,-16,28,44,-16,-30
2013-2014,5959,Northern Rockies,80,0,2,0,-86,-4,133,262,-129,157,258,-101,-234
2014-2015,5900,British Columbia,31672,12771,6462,5234,-923,19206,61026,40647,20379,84998,84998,0,39585
2014-2015,5901,East Kootenay,235,55,54,23,-80,131,1482,1142,340,1100,1144,-44,427
2014-2015,5903,Central Kootenay,54,65,55,27,103,120,1233,717,516,1488,1617,-129,507
2014-2015,5905,Kootenay Boundary,44,29,16,12,-56,-37,435,258,177,988,1004,-16,124
2014-2015,5907,Okanagan-Similkameen,157,136,51,55,46,63,1866,1025,841,2759,2568,191,1095
2014-2015,5909,Fraser Valley,1228,374,224,148,-14,916,3136,2288,848,10161,7543,2618,4382
2014-2015,5915,Greater Vancouver,25159,9752,4911,3991,562,16889,23757,17475,6282,17530,23119,-5589,17582
2014-2015,5917,Capital,1559,768,407,324,-1016,-142,6908,3710,3198,8581,7026,1555,4611
2014-2015,5919,Cowichan Valley,161,83,46,34,-46,44,1145,604,541,3146,2915,231,816
2014-2015,5921,Nanaimo,363,174,105,72,71,293,2875,1312,1563,5356,4524,832,2688
2014-2015,5923,Alberni-Clayoquot,50,22,6,9,11,36,391,180,211,958,1119,-161,86
2014-2015,5924,Strathcona,65,44,27,19,-15,14,677,352,325,1683,1568,115,454
2014-2015,5926,Comox Valley,121,102,53,42,-11,19,1493,748,745,2303,1950,353,1117
2014-2015,5927,Powell River,25,27,7,11,2,-4,170,132,38,588,691,-103,-69
2014-2015,5929,Sunshine Coast,53,42,22,17,36,52,326,153,173,1183,1071,112,337
2014-2015,5931,Squamish-Lillooet,364,154,62,63,-201,8,823,405,418,1837,1683,154,580
2014-2015,5933,Thompson-Nicola,239,202,62,82,-76,-59,1704,1334,370,4345,3857,488,799
2014-2015,5935,Central Okanagan,531,311,160,128,318,570,5312,2717,2595,6033,4632,1401,4566
2014-2015,5937,North Okanagan,139,111,52,45,-73,-38,1750,1052,698,2838,2755,83,743
2014-2015,5939,Columbia-Shuswap,107,63,24,26,34,76,1303,731,572,1953,1808,145,793
2014-2015,5941,Cariboo,100,51,29,21,5,62,566,509,57,1987,2339,-352,-233
2014-2015,5943,Mount Waddington,28,5,1,2,-89,-67,136,62,74,420,648,-228,-221
2014-2015,5945,Central Coast,2,10,0,4,2,-10,19,20,-1,118,172,-54,-65
2014-2015,5947,Skeena-Queen Charlotte,27,2,5,1,-38,-9,176,140,36,601,721,-120,-93
2014-2015,5949,Kitimat-Stikine,67,54,23,22,-97,-83,441,370,71,1077,1400,-323,-335
2014-2015,5951,Bulkley-Nechako,62,21,18,9,-10,40,343,319,24,1061,1625,-564,-500
2014-2015,5953,Fraser-Fort George,301,50,27,20,-139,119,1060,946,114,2838,2931,-93,140
2014-2015,5955,Peace River,383,55,10,23,-100,215,1375,1652,-277,1928,2224,-296,-358
2014-2015,5957,Stikine,2,5,1,2,-2,-6,10,21,-11,21,39,-18,-35
2014-2015,5959,Northern Rockies,46,4,4,2,-50,-6,114,273,-159,117,305,-188,-353
2015-2016,5900,British Columbia,43242,13172,6747,5234,-1664,29919,63788,37215,26573,91080,91080,0,56492
2015-2016,5901,East Kootenay,264,83,46,33,17,211,1489,1100,389,980,1227,-247,353
2015-2016,5903,Central Kootenay,123,104,43,42,251,271,1266,630,636,1531,1755,-224,683
2015-2016,5905,Kootenay Boundary,48,37,27,14,14,38,526,277,249,1159,964,195,482
2015-2016,5907,Okanagan-Similkameen,225,128,37,51,109,192,1811,880,931,3139,2490,649,1772
2015-2016,5909,Fraser Valley,1569,480,184,182,606,1697,3398,2065,1333,12550,8365,4185,7215
2015-2016,5915,Greater Vancouver,34750,9574,4942,3788,-5230,21100,25282,16187,9095,18024,27952,-9928,20267
2015-2016,5917,Capital,1816,884,529,374,-18,1069,7625,3707,3918,9283,7173,2110,7097
2015-2016,5919,Cowichan Valley,223,86,62,34,123,288,1203,548,655,3587,3099,488,1431
2015-2016,5921,Nanaimo,440,261,121,104,108,304,2998,1241,1757,5810,4620,1190,3251
2015-2016,5923,Alberni-Clayoquot,76,27,17,10,14,70,365,178,187,1191,1059,132,389
2015-2016,5924,Strathcona,111,79,24,32,39,63,729,303,426,1805,1471,334,823
2015-2016,5926,Comox Valley,117,106,61,43,244,273,1348,781,567,2381,2015,366,1206
2015-2016,5927,Powell River,45,20,11,8,63,91,244,97,147,733,650,83,321
2015-2016,5929,Sunshine Coast,119,63,27,25,3,61,389,156,233,1388,1221,167,461
2015-2016,5931,Squamish-Lillooet,542,143,62,57,866,1270,797,377,420,1940,1666,274,1964
2015-2016,5933,Thompson-Nicola,414,210,70,83,180,371,1856,1105,751,4615,3860,755,1877
2015-2016,5935,Central Okanagan,722,381,252,152,838,1279,5225,2455,2770,6228,4990,1238,5287
2015-2016,5937,North Okanagan,178,135,58,54,-5,42,1756,822,934,2960,2573,387,1363
2015-2016,5939,Columbia-Shuswap,129,63,26,25,89,156,1346,613,733,1966,1877,89,978
2015-2016,5941,Cariboo,155,69,29,27,-19,69,588,378,210,2080,2245,-165,114
2015-2016,5943,Mount Waddington,24,11,10,5,-98,-80,130,66,64,441,540,-99,-115
2015-2016,5945,Central Coast,7,0,3,0,-1,9,27,4,23,122,109,13,45
2015-2016,5947,Skeena-Queen Charlotte,35,20,9,8,33,49,204,110,94,597,729,-132,11
2015-2016,5949,Kitimat-Stikine,109,53,16,21,-146,-95,471,348,123,1068,1428,-360,-332
2015-2016,5951,Bulkley-Nechako,100,41,9,17,44,95,347,261,86,1126,1431,-305,-124
2015-2016,5953,Fraser-Fort George,352,71,43,28,148,444,1124,854,270,2821,2895,-74,640
2015-2016,5955,Peace River,475,43,23,17,79,517,1142,1438,-296,1412,2388,-976,-755
2015-2016,5957,Stikine,1,0,0,0,0,1,9,28,-19,23,32,-9,-27
2015-2016,5959,Northern Rockies,73,0,6,0,-15,64,93,206,-113,120,256,-136,-185
2016-2017,5900,British Columbia,35397,11892,6400,5296,20059,44668,57210,38376,18834,91309,91309,0,63502
2016-2017,5901,East Kootenay,207,81,41,36,170,301,1323,1109,214,1035,1069,-34,481
2016-2017,5903,Central Kootenay,114,123,46,54,317,300,1171,691,480,1681,1699,-18,762
2016-2017,5905,Kootenay Boundary,51,63,27,28,31,18,474,234,240,1189,982,207,465
2016-2017,5907,Okanagan-Similkameen,164,103,65,47,116,195,1710,945,765,3348,2478,870,1830
2016-2017,5909,Fraser Valley,1442,341,198,152,1349,2496,2892,2308,584,12010,8681,3329,6409
2016-2017,5915,Greater Vancouver,28023,8595,4647,3816,13544,33803,22827,17110,5717,16739,29838,-13099,26421
2016-2017,5917,Capital,1737,951,458,443,864,1665,6780,3834,2946,9385,7162,2223,6834
2016-2017,5919,Cowichan Valley,166,89,69,40,166,272,1114,601,513,3716,2859,857,1642
2016-2017,5921,Nanaimo,351,209,110,93,546,705,2563,1259,1304,6162,4394,1768,3777
2016-2017,5923,Alberni-Clayoquot,57,23,15,11,37,75,309,211,98,1255,1083,172,345
2016-2017,5924,Strathcona,83,53,27,23,-22,12,675,292,383,1947,1490,457,852
2016-2017,5926,Comox Valley,103,87,62,38,213,253,1264,734,530,2765,2027,738,1521
2016-2017,5927,Powell River,23,55,12,25,44,-1,168,78,90,715,554,161,250
2016-2017,5929,Sunshine Coast,79,15,37,6,36,131,266,143,123,1446,1233,213,467
2016-2017,5931,Squamish-Lillooet,469,157,76,70,253,571,782,414,368,1793,1917,-124,815
2016-2017,5933,Thompson-Nicola,333,158,63,71,906,1073,1705,1165,540,4619,3629,990,2603
2016-2017,5935,Central Okanagan,539,352,212,147,739,991,4725,2556,2169,6587,4861,1726,4886
2016-2017,5937,North Okanagan,179,128,76,57,58,128,1527,762,765,3384,2819,565,1458
2016-2017,5939,Columbia-Shuswap,163,44,29,20,79,207,1203,607,596,2136,1812,324,1127
2016-2017,5941,Cariboo,128,38,25,17,27,125,523,375,148,2240,2037,203,476
2016-2017,5943,Mount Waddington,19,14,8,7,-17,-11,85,49,36,459,420,39,64
2016-2017,5945,Central Coast,7,3,1,1,0,4,20,15,5,127,107,20,29
2016-2017,5947,Skeena-Queen Charlotte,58,0,3,0,19,80,172,119,53,532,633,-101,32
2016-2017,5949,Kitimat-Stikine,113,30,14,13,-63,21,386,312,74,978,1241,-263,-168
2016-2017,5951,Bulkley-Nechako,82,39,29,17,-28,27,368,296,72,1069,1381,-312,-213
2016-2017,5953,Fraser-Fort George,264,57,36,26,473,690,1087,806,281,2586,2528,58,1029
2016-2017,5955,Peace River,401,63,9,28,234,553,997,1168,-171,1303,2036,-733,-351
2016-2017,5957,Stikine,2,0,0,0,1,3,14,26,-12,17,40,-23,-32
2016-2017,5959,Northern Rockies,40,21,5,10,-33,-19,80,157,-77,86,299,-213,-309
2017-2018,5900,British Columbia,41916,10994,6062,5358,29297,60923,55300,41311,13989,93658,93658,0,74912
2017-2018,5901,East Kootenay,207,88,43,43,207,326,1519,1065,454,1153,1086,67,847
2017-2018,5903,Central Kootenay,159,95,55,47,289,361,1132,693,439,1841,1792,49,849
2017-2018,5905,Kootenay Boundary,73,43,20,21,86,115,405,273,132,1374,1011,363,610
2017-2018,5907,Okanagan-Similkameen,230,103,39,50,764,880,1462,1021,441,3540,2720,820,2141
2017-2018,5909,Fraser Valley,1513,367,164,175,3462,4597,2590,2852,-262,11858,8694,3164,7499
2017-2018,5915,Greater Vancouver,33295,7995,4360,3906,18904,44658,22027,18258,3769,16044,30484,-14440,33987
2017-2018,5917,Capital,1917,755,514,360,532,1848,6586,3775,2811,9402,7159,2243,6902
2017-2018,5919,Cowichan Valley,135,114,67,56,63,95,973,612,361,3898,3057,841,1297
2017-2018,5921,Nanaimo,483,199,126,97,323,636,2449,1454,995,6464,4535,1929,3560
2017-2018,5923,Alberni-Clayoquot,59,26,9,13,38,67,295,178,117,1361,1085,276,460
2017-2018,5924,Strathcona,71,76,38,37,62,58,674,359,315,2204,1563,641,1014
2017-2018,5926,Comox Valley,159,48,62,24,231,380,1212,694,518,2775,2155,620,1518
2017-2018,5927,Powell River,62,18,13,9,15,63,164,100,64,724,589,135,262
2017-2018,5929,Sunshine Coast,88,59,44,29,-14,30,288,200,88,1461,1156,305,423
2017-2018,5931,Squamish-Lillooet,646,187,69,91,-97,340,760,464,296,1702,2132,-430,206
2017-2018,5933,Thompson-Nicola,409,124,49,60,1882,2156,1595,1346,249,5046,3809,1237,3642
2017-2018,5935,Central Okanagan,726,347,198,169,1534,1942,4639,2694,1945,6730,5194,1536,5423
2017-2018,5937,North Okanagan,179,109,70,53,111,198,1457,942,515,3616,2940,676,1389
2017-2018,5939,Columbia-Shuswap,169,28,28,13,35,191,1181,725,456,2257,1901,356,1003
2017-2018,5941,Cariboo,130,30,14,15,7,106,554,435,119,2462,2202,260,485
2017-2018,5943,Mount Waddington,19,6,4,3,-23,-9,112,62,50,508,465,43,84
2017-2018,5945,Central Coast,2,0,5,0,0,7,24,24,0,159,113,46,53
2017-2018,5947,Skeena-Queen Charlotte,41,12,1,6,-35,-11,185,118,67,568,586,-18,38
2017-2018,5949,Kitimat-Stikine,142,15,8,7,136,264,348,287,61,912,1198,-286,39
2017-2018,5951,Bulkley-Nechako,77,15,13,8,22,89,329,295,34,1084,1329,-245,-122
2017-2018,5953,Fraser-Fort George,387,66,23,32,655,967,1016,855,161,2863,2493,370,1498
2017-2018,5955,Peace River,494,69,26,34,106,523,1217,1329,-112,1507,1897,-390,21
2017-2018,5957,Stikine,0,0,0,0,6,6,33,20,13,39,50,-11,8
2017-2018,5959,Northern Rockies,44,0,0,0,-4,40,74,181,-107,106,263,-157,-224
2018-2019,5900,British Columbia,43135,9452,6061,5437,31809,66116,53434,40109,13325,86187,86187,0,79441
2018-2019,5901,East Kootenay,229,70,53,40,189,361,1590,955,635,1107,1016,91,1087
2018-2019,5903,Central Kootenay,199,90,31,52,165,253,1092,703,389,1722,1628,94,736
2018-2019,5905,Kootenay Boundary,73,43,15,25,50,70,419,270,149,1184,1014,170,389
2018-2019,5907,Okanagan-Similkameen,251,86,55,49,325,496,1269,924,345,3231,2457,774,1615
2018-2019,5909,Fraser Valley,1539,291,159,159,2786,4034,2399,2407,-8,10301,8502,1799,5825
2018-2019,5915,Greater Vancouver,34562,6842,4432,3924,23306,51534,21755,18395,3360,15240,27091,-11851,43043
2018-2019,5917,Capital,2079,720,540,435,1085,2549,6667,3550,3117,8673,6731,1942,7608
2018-2019,5919,Cowichan Valley,144,84,59,48,47,118,918,580,338,3426,2930,496,952
2018-2019,5921,Nanaimo,491,169,120,97,522,867,2360,1319,1041,5806,4403,1403,3311
2018-2019,5923,Alberni-Clayoquot,71,21,12,12,59,109,285,161,124,1300,908,392,625
2018-2019,5924,Strathcona,76,53,32,31,84,108,544,341,203,1925,1498,427,738
2018-2019,5926,Comox Valley,151,55,50,32,89,203,1160,751,409,2677,1909,768,1380
2018-2019,5927,Powell River,48,29,8,17,-11,-1,187,83,104,696,582,114,217
2018-2019,5929,Sunshine Coast,99,31,18,18,38,106,248,201,47,1274,1099,175,328
2018-2019,5931,Squamish-Lillooet,590,143,55,83,-63,356,655,409,246,1578,1884,-306,296
2018-2019,5933,Thompson-Nicola,406,116,45,67,545,813,1427,1284,143,4720,3630,1090,2046
2018-2019,5935,Central Okanagan,835,286,187,160,1159,1735,4449,2579,1870,6344,4795,1549,5154
2018-2019,5937,North Okanagan,155,98,45,57,140,185,1270,927,343,3284,2387,897,1425
2018-2019,5939,Columbia-Shuswap,165,30,29,17,140,287,1060,731,329,2169,1765,404,1020
2018-2019,5941,Cariboo,84,27,12,16,61,114,459,490,-31,2324,2023,301,384
2018-2019,5943,Mount Waddington,10,8,7,5,-10,-6,109,60,49,475,418,57,100
2018-2019,5945,Central Coast,3,1,0,1,-1,0,29,19,10,105,101,4,14
2018-2019,5947,Skeena-Queen Charlotte,37,5,2,3,11,42,165,102,63,561,665,-104,1
2018-2019,5949,Kitimat-Stikine,75,18,16,10,222,285,443,304,139,942,1057,-115,309
2018-2019,5951,Bulkley-Nechako,105,22,14,13,15,99,416,323,93,1091,1297,-206,-14
2018-2019,5953,Fraser-Fort George,333,51,18,30,692,962,907,816,91,2526,2493,33,1086
2018-2019,5955,Peace River,305,55,47,32,160,425,1055,1283,-228,1371,1678,-307,-110
2018-2019,5957,Stikine,0,0,0,0,-3,-3,20,23,-3,41,56,-15,-21
2018-2019,5959,Northern Rockies,20,8,0,4,7,15,77,119,-42,94,170,-76,-103
2019-2020,5900,British Columbia,44805,6918,5778,4930,1022,39757,60584,43585,16999,91253,91253,0,56756
2019-2020,5901,East Kootenay,198,58,31,42,-146,-17,1602,1034,568,1169,1144,25,576
2019-2020,5903,Central Kootenay,152,36,46,25,27,164,1155,680,475,1784,1680,104,743
2019-2020,5905,Kootenay Boundary,69,69,13,49,-18,-54,396,292,104,1231,1029,202,252
2019-2020,5907,Okanagan-Similkameen,185,62,58,44,51,188,1420,940,480,3311,2598,713,1381
2019-2020,5909,Fraser Valley,1405,242,110,166,-184,923,2936,2661,275,11237,9141,2096,3294
2019-2020,5915,Greater Vancouver,36449,4932,4171,3512,1106,33282,25923,20915,5008,17427,28575,-11148,27142
2019-2020,5917,Capital,2017,564,523,412,-261,1303,7565,3795,3770,9302,7503,1799,6872
2019-2020,5919,Cowichan Valley,119,48,51,34,-159,-71,998,692,306,3606,2889,717,952
2019-2020,5921,Nanaimo,456,130,101,93,-371,-37,2403,1274,1129,6248,4754,1494,2586
2019-2020,5923,Alberni-Clayoquot,54,10,13,7,47,97,332,203,129,1284,1038,246,472
2019-2020,5924,Strathcona,77,42,15,30,39,59,543,285,258,1965,1580,385,702
2019-2020,5926,Comox Valley,136,31,73,22,-134,22,1295,832,463,2659,1938,721,1206
2019-2020,5927,Powell River,35,4,9,2,-21,17,187,108,79,724,523,201,297
2019-2020,5929,Sunshine Coast,79,49,24,35,-66,-47,236,196,40,1332,1026,306,299
2019-2020,5931,Squamish-Lillooet,698,108,72,76,-152,434,800,458,342,1782,1985,-203,573
2019-2020,5933,Thompson-Nicola,383,86,76,61,-14,298,1639,1249,390,4585,3859,726,1414
2019-2020,5935,Central Okanagan,865,170,199,120,554,1328,4873,2688,2185,6633,4929,1704,5217
2019-2020,5937,North Okanagan,155,34,60,24,237,394,1349,860,489,3317,2644,673,1556
2019-2020,5939,Columbia-Shuswap,236,18,22,13,-17,210,1077,803,274,2195,1915,280,764
2019-2020,5941,Cariboo,132,35,15,26,15,101,493,529,-36,2183,2138,45,110
2019-2020,5943,Mount Waddington,17,3,4,2,-5,11,96,60,36,409,495,-86,-39
2019-2020,5945,Central Coast,3,4,4,3,0,0,29,12,17,120,108,12,29
2019-2020,5947,Skeena-Queen Charlotte,43,2,0,2,48,87,192,99,93,578,666,-88,92
2019-2020,5949,Kitimat-Stikine,74,23,10,17,183,227,468,324,144,1036,1053,-17,354
2019-2020,5951,Bulkley-Nechako,102,47,17,33,7,46,436,333,103,1050,1359,-309,-160
2019-2020,5953,Fraser-Fort George,326,61,37,44,372,630,929,905,24,2719,2653,66,720
2019-2020,5955,Peace River,309,46,18,33,-107,141,1121,1208,-87,1238,1812,-574,-520
2019-2020,5957,Stikine,4,0,0,0,-2,2,21,17,4,32,43,-11,-5
2019-2020,5959,Northern Rockies,27,4,6,3,-7,19,70,133,-63,97,176,-79,-123
2020-2021,5900,British Columbia,34388,7189,5418,3699,-7547,21371,59313,33937,25376,83092,83092,0,46747
2020-2021,5901,East Kootenay,169,80,43,42,-263,-173,1675,869,806,1094,971,123,756
2020-2021,5903,Central Kootenay,117,67,56,34,-120,-48,1235,592,643,1486,1548,-62,533
2020-2021,5905,Kootenay Boundary,58,13,9,6,32,80,436,254,182,1206,853,353,615
2020-2021,5907,Okanagan-Similkameen,120,82,51,43,128,174,1544,717,827,2914,2244,670,1671
2020-2021,5909,Fraser Valley,950,216,167,103,-170,628,2889,2015,874,10592,8075,2517,4019
2020-2021,5915,Greater Vancouver,27998,5061,3818,2609,-4081,20065,25086,16039,9047,14768,27835,-13067,16045
2020-2021,5917,Capital,1646,532,437,279,-1083,189,6995,2927,4068,8419,6868,1551,5808
2020-2021,5919,Cowichan Valley,92,78,64,39,-65,-26,1022,483,539,3114,2541,573,1086
2020-2021,5921,Nanaimo,363,147,111,74,-521,-268,2337,1051,1286,5759,3899,1860,2878
2020-2021,5923,Alberni-Clayoquot,65,2,8,1,16,86,337,155,182,1204,877,327,595
2020-2021,5924,Strathcona,75,33,30,17,-14,41,596,275,321,1790,1334,456,818
2020-2021,5926,Comox Valley,109,63,64,32,-108,-30,1165,606,559,2552,1796,756,1285
2020-2021,5927,Powell River,17,21,13,10,1,0,218,80,138,639,454,185,323
2020-2021,5929,Sunshine Coast,73,49,43,26,-11,30,229,154,75,1384,905,479,584
2020-2021,5931,Squamish-Lillooet,562,131,77,67,-935,-494,836,422,414,1756,1798,-42,-122
2020-2021,5933,Thompson-Nicola,281,120,68,61,-541,-373,1517,1027,490,4280,3520,760,877
2020-2021,5935,Central Okanagan,686,135,211,70,372,1064,5132,2077,3055,6342,4533,1809,5928
2020-2021,5937,North Okanagan,121,117,60,60,-104,-100,1411,697,714,3177,2361,816,1430
2020-2021,5939,Columbia-Shuswap,162,39,34,20,-92,45,1188,590,598,2081,1616,465,1108
2020-2021,5941,Cariboo,95,37,13,20,28,79,411,335,76,2097,1781,316,471
2020-2021,5943,Mount Waddington,10,10,0,5,-5,-10,143,41,102,437,424,13,105
2020-2021,5945,Central Coast,3,6,0,3,4,-2,10,10,0,136,80,56,54
2020-2021,5947,Skeena-Queen Charlotte,42,0,0,0,94,136,154,97,57,411,475,-64,129
2020-2021,5949,Kitimat-Stikine,67,36,8,18,46,67,509,260,249,847,893,-46,270
2020-2021,5951,Bulkley-Nechako,65,15,4,8,188,234,348,256,92,1059,1065,-6,320
2020-2021,5953,Fraser-Fort George,191,49,21,25,-353,-215,875,816,59,2265,2479,-214,-370
2020-2021,5955,Peace River,232,42,8,22,11,187,907,1004,-97,1116,1675,-559,-469
2020-2021,5957,Stikine,7,0,0,0,-2,5,22,12,10,31,34,-3,12
2020-2021,5959,Northern Rockies,12,8,0,5,1,0,86,76,10,136,158,-22,-12
2021-2022,5900,British Columbia,83200,10006,6253,6076,30303,103674,70788,54919,15869,86521,86521,0,119543
2021-2022,5901,East Kootenay,393,111,50,68,-38,226,1974,1377,597,1176,974,202,1025
2021-2022,5903,Central Kootenay,438,92,64,56,19,373,1451,928,523,1566,1555,11,907
2021-2022,5905,Kootenay Boundary,157,17,10,10,-53,87,517,423,94,1271,897,374,555
2021-2022,5907,Okanagan-Similkameen,421,115,59,70,78,373,1764,1179,585,3037,2303,734,1692
2021-2022,5909,Fraser Valley,3428,299,192,181,188,3328,3428,3685,-257,11184,8527,2657,5728
2021-2022,5915,Greater Vancouver,65975,7052,4399,4285,24969,84006,29701,25531,4170,14894,29221,-14327,73849
2021-2022,5917,Capital,3742,734,507,446,2830,5899,8295,4628,3667,8425,7106,1319,10885
2021-2022,5919,Cowichan Valley,274,107,74,66,154,329,1209,788,421,3346,2568,778,1528
2021-2022,5921,Nanaimo,884,204,127,123,236,920,2821,1743,1078,5959,4068,1891,3889
2021-2022,5923,Alberni-Clayoquot,158,3,10,2,31,194,411,258,153,1267,913,354,701
2021-2022,5924,Strathcona,161,46,35,27,54,177,706,455,251,1894,1386,508,936
2021-2022,5926,Comox Valley,308,88,74,54,60,300,1424,1061,363,2684,1855,829,1492
2021-2022,5927,Powell River,61,29,15,17,49,79,262,153,109,688,455,233,421
2021-2022,5929,Sunshine Coast,123,70,50,42,117,178,283,249,34,1463,949,514,726
2021-2022,5931,Squamish-Lillooet,1028,182,89,110,-358,467,1002,632,370,1804,1848,-44,793
2021-2022,5933,Thompson-Nicola,818,167,79,102,1136,1764,1883,1606,277,4360,3603,757,2798
2021-2022,5935,Central Okanagan,2021,189,245,114,590,2553,6221,3451,2770,6606,4887,1719,7042
2021-2022,5937,North Okanagan,456,164,69,99,149,411,1778,1118,660,3448,2472,976,2047
2021-2022,5939,Columbia-Shuswap,374,54,40,32,15,343,1415,950,465,2251,1636,615,1423
2021-2022,5941,Cariboo,206,53,15,32,-64,72,533,542,-9,2270,1821,449,512
2021-2022,5943,Mount Waddington,16,14,0,8,12,6,150,69,81,467,443,24,111
2021-2022,5945,Central Coast,4,8,0,5,1,-8,28,11,17,161,90,71,80
2021-2022,5947,Skeena-Queen Charlotte,93,0,0,0,33,126,191,179,12,428,495,-67,71
2021-2022,5949,Kitimat-Stikine,238,49,10,30,172,341,607,448,159,908,964,-56,444
2021-2022,5951,Bulkley-Nechako,178,20,5,12,21,172,456,421,35,1103,1099,4,211
2021-2022,5953,Fraser-Fort George,682,68,25,42,-164,433,1019,1314,-295,2473,2537,-64,74
2021-2022,5955,Peace River,534,59,10,36,76,525,1140,1559,-419,1212,1647,-435,-329
2021-2022,5957,Stikine,2,0,0,0,0,2,35,19,16,33,36,-3,15
2021-2022,5959,Northern Rockies,27,12,0,7,-10,-2,84,142,-58,143,166,-23,-83
